######
#\\\\#
## ###
##*###
## ###
## ###
## ###
## ###
## ###
##*###
## ###
## ###
## ###
## ###
## ###
## ###
#   ##
# * ##
# # ##
# R ##
#   ##
#   ##
##L###
######
