#########
#**###**#
#  ###  #
    R     
 ########
    #***#
    #***#
    \***\
    #***#
    #***#
    #***#
    #***#
    #***#
    #***#
    #***#
    #***#
    #***#
    #***#
    #***##
    # **#
    ##**#
    ## *# #######
    ###*# #*#####
### ### #  .   L#
### ########### #
### #######*### #
###        .    #
#################
