#######
#\\\#*#
#\\\# #
#   # #
### # #
#*# # #
# # # #
# # # #
# # # #
#  R  #
# ### #
# ### #
#  #  #
#*   *#
##* *##
### ###
### ###
### \L#
### ###
#######
