########
#     ##
# # #*##
# # # ##
# # # ##
# # # ##
# # # ##
# # # ##
# # # ##
# .*. .#
# ..# *#
# ### ##
# ##. .#
# ### *#
# ### ##
# .*. .#
###.#R*#
###\# ##
###\# ##
###\# ##
###\# ##
###\# ##
###\#L##
########
